OOOOOOOOOOOOOOOOOOOOOOOOOOOOOOOOOOOOOOOO
O......................................O
O......................................O
O......................................O
O............L............R............O
O........uuuuuuuuu....uuuuuuuuu........O
O........OOOOOOOOO....OOOOOOOOO........O
O......................................O
O......................................O
O.............................^........O
O.............................O........O
O....OOOO..uuuuuuuuuuuuuuuuuuuO........O
O....OOOO^^OOOOOOOOOOOOOOOOOOOO........O
OO.....................................O
O.O....................................O
O..O...................................O
O...O..................................O
O....OOdddddO..OOOOOOO..OuuO..OuuuO..^^O
O....OOOOOOOO^^OOOOOOO^^OOOO^^OOOOO..OOO
O......................................O
O......................................O
O......................................O
O......................................O
O....OO..OOOOOOOOOOO..OOOOOOOOOOOOOOOOOO
O....OO^^OOOOOOOOOOO^^OOOOOOOOOOOOOOOOOO
O......................................O
O......................................O
O....................................GGO
O....................................GGO
OOOOOO..OuuuuO..OuuuuO..OuuuuO..OuuuuOOO
OOOOOO^^OOOOOO^^OOOOOO^^OOOOOO^^OOOOOOOO
