OOOOOOOOOOOOOOOOOOOOOOOOOOOOOOOOOOOOOOOO
........................................
........................................
........................................
........................................
........................................
........................................
........................................
........................................
........................................
........................................
........................................
........................................
........................................
........................................
........................................
........................................
........................................
........................................
........................................
........................................
........................................
........................................
........................................
........................................
........................................
L...O..............GG..............O...R
OOOOOOOOOOOOOO..OOOOOOOO..OOOOOOOOOOOOOO
OOOOOOOOOOOOOO..OOOOOOOO..OOOOOOOOOOOOOO
OOOOOOOOOOOOOO^^OOOOOOOO^^OOOOOOOOOOOOOO