OOOOOOOOOOOOOOOOOOOOOOOOOOOOOOOOOOOOOOOO
O......................................O
O......................................O
O......................................O
O......................................O
O......................................O
O......................................O
O......................................O
O......................................O
O......................................O
O......................................O
O......................................O
O......................................O
O......................................O
O......................................O
O......................................O
O......................................O
O......................................O
O......................................O
O......................................O
O......................................O
O......................................O
O......................................O
O......................................O
O......................................O
O......................................O
O......................................O
O..................GG..................O
OL...O.............GG.............O...RO
OOOOOOOOOOOOOOOOOOOOOOOOOOOOOOOOOOOOOOOO
OOOOOOOOOOOOOOOOOOOOOOOOOOOOOOOOOOOOOOOO
